TILEMAP
32 15 							-- Size of tile map in tiles
16 16 							-- Tile size & block size
images/blocks.png 	-- Tilesheet
4 4 								-- Number of tiles in tilesheet
--------------------------------
--------------------------------
--------------------------------
--------------------------------
--------------------------------
--------------------------------
--------------------------------
--------------------------------
----22----5---------------------
----22--------------------------
--------------------------------
----5---15151-------------------
--------------------------------
------------5-------------------
33333333333333333333333333333333
