TILEMAP
112 15 							-- Size of tile map in tiles
16 16 							-- Tile size & block size
images/backgrounds.png 	-- Tilesheet
8 8 								-- Number of tiles in tilesheet
------PQSSSVSLSSSSWSRT----PQSSSVSMSSSSSSVSSSSSWRT---------------------------------------------------------------
-------PUUUUUMUUUUUUT------PUUUUULUUUQSSSSVSSSRT----------------------------------------------------------------
-------------LO-----------------NM---PUUUUUUUUT-----------------------------------------------------------------
-------------M-------------------L------------------------------------------------------------------------------
-------------L-------------------MO-----------------------------------------------------------------------------
-------------M-------------------L------------------------------------------------------------------------------
-------------LO------------------MO-----------------------------------------------------------------------------
-------------M-------------------L------------------------------------------------------------------------------
-------------L------------------NM------------------------------------------------------------------------------
-------------M-------------------L------------------------------------------------------------------------------
------------NL-------------------M------------------------------------------------------------------------------
-------------MO------------------LO-----------------------------------------------------------------------------
-------------L------------------NM------------------------------------------------------------------------------
------------NM-------------------LO-----------------------------------------------------------------------------
-------------L-------------------M------------------------------------------------------------------------------
