TILEMAP
112 15 							-- Size of tile map in tiles
16 16 							-- Tile size & block size
images/backgrounds.png 	-- Tilesheet
8 8 								-- Number of tiles in tilesheet
----------------------------------------------------------------------------------------------------------------
--------M------------------------------------FG-----------------------------------------------------------------
-------NM-------------------------------------------------------------------------------------------------------
--------L-----------------------------FG---------------FG-------------------------------------------------------
5667----M-------------------------------------------------------------------------------------------------------
899:----MO---------------5667-------------<=---------------FG---------------------------------------------------
--------L----------------899:MO-----------------------------------------------------------------------<=--------
--------L--5667--------------L----------------------------------------------------------------------------------
--------M--899:--------------M-------------------D------J-------------------------------------------------------
-------NL--------------------LO------------------E------K-------------------------------------------------------
--------L-------------------NM-------------------B------B-------------------------------------------------------
--------M--------------------M-------------------C------C-------------------------------------------------------
--------M--------------------M-------------------C------C-------------------------------------------------------
--------M--------------------L-------------------B------B-------------------------------------------------------
HHAAHHHHHHAHAAHH---------------------------------B------B-------------------------------------------------------
