TILEMAP
112 15 							-- Size of tile map in tiles
16 16 							-- Tile size & block size
images/blocks.png 	-- Tilesheet
8 8 								-- Number of tiles in tilesheet
WVWVWVWVWVWVWVWVWVWVWVWVWVWVWVWVWVWVWVWVWVWVWVWVWVWVWVWVWVWVWVWVWVWVWVWVWVWVWVWVWVWVWVWVW-----------------------
VWVWVWVWVWVWVWVWVWVWVWVWVWVWVWVWVWVWVWVWVWVWVWVWVWVWVWVWVWVWVWVWVWVWVWVWVWVWVWVWVWVWVWVWV-----------------------
WVWVWVWVWVWVWVWVWVWVWVWVWVWVWVWVWVWVWVWVWVWVWVWVWVWVWVWVWVWVWVWVWVWVWVWVWVWVWVWVWVWVWVWVW-----------------------
VWVW---------------------------------------------------------------------------------WVWV-----------------------
WVW------------------------------------------------------------------------------222--WVW-----------------------
VW-------------------------------------------------------------------------------222---WV--------------=--------
W-----------------------------15-----------------------------------------------1511151--W-------------->--------
---------------------------------------7------------------------------2222-----------------------2U---->--------
--------------6-5---------------------------------------------------U------U---------------------VW---->--------
-----2-----2--------------1----1-----------2---222--2--222---------NOOOOOOOOP-2-1---1----------2VWV---->--------
---2-2-2-----------------222--222-------------------X--------------QSSSSSSSSR-2----------------VWVW---->--------
-------------NOTOP---------------------NOO_--X-----XXX-----X--^OP--Y]\ZZZZ]\[--2-------------2VWVWV---->--------
OOOOOOOOOP---QSSSR---221---------1U----QSSR-XXXXXXXXXXXXXXXXX-QSR---QR----QR------1------22--VWVWVW---->--------
SSSSSSSSSR---QSSSR---NOOOOOOOOOOOOOOP--QSSR-------------------QSR---QR----QR--NOOOOOOOOP----VWVWVWV---->--------
SSSSSSSSSR---QSSSR---QSSSSSSSSSSSSSSR--QSSR-------------------QSR---QR----QR--QSSSSSSSSRFFFFFFFFFFFFFFFFFFFFFFFF
