TILEMAP
112 15 							-- Size of tile map in tiles
16 16 							-- Tile size & block size
images/backgrounds.png 	-- Tilesheet
8 8 								-- Number of tiles in tilesheet
----------------------------------------------------------------------------------------------------------------
---------------------------p----------p-------------p---------p-------------------p-----------------------------
-----p----p---------p-----pp------p---p---------p---p---p-----pp-----p----p------ppp----------------------------
-----p----p---------p-----pp------p---p--------pp---p---p-----pp-----p----p------ppp----------------------------
-----p----p---------p-----pp------p------------pp---p---p------p-----p----p------ppp----------------------------
-----p--------------p-----pp------p------------pp-------p------p-----p----p------ppp----------------------------
-----p--------------------pp-------------------pp-------p------------p----p------ppp----------------------------
-----p---------------------p-------------------pp-------p------------p----p------p-p----------------------------
-----p-----------------------------------------pp-------------------------p------p------------------------------
-----p-----------------------------------------p----------------------------------------------------------------
-----p----------------------------------------------------------------------------------------------------------
-------------------------------------------l-----------------k--------------------------------------------------
----------------------------------------------------------------------------------------------------------------
----------bbb------------------------bb--------------------------bbb--bbbb--bb----------------------------------
----------ccc-----bbb----------------cc----bbbbbbbbbbbbbbbbbbb---ccc--cccc--cc----------------------------------
