TILEMAP
112 15 							-- Size of tile map in tiles
16 16 							-- Tile size & block size
images/blocks.png 	-- Tilesheet
4 4 								-- Number of tiles in tilesheet
----------------------------------------------------------------------------------------------------------------
----------------------------------------------------------------------------------------------------------------
----------------------------------------------------------------------------------------------------------------
----------------------------------------------------------------------------------------------------------------
----------------------------------------------------------------------------------------------------------------
----------------------------------------------------------------------------------------------------------------
---2--2--5----2-22----5-------------5--5------------------------------------------------------------------------
--------2-------------2------5--5-----------5-------------------5---5---5-------------5-------------------------
------------------------------------------------------5-5-------------------------------------------------------
----3-----3----3---3----3---3-----3-------3-----3--3----3---3----3---3---3----3---3-----3---3-------------3-----
----------------------------------------------------------------------------------------------------------------
----------------------------3---1-----1------------------3---3-------------3---3------------------1---1---------
----5---151515--------5---------------5-----------5-----1--------1-------------1-----------------1--------------
------------------------1-------------1-----------------1-------------1----------------1-----------------1------
33333333333333333333333333333333333333333333333333333333333333333333333333333333333333333333333333333333--------
