TILEMAP
112 15 							-- Size of tile map in tiles
16 16 							-- Tile size & block size
images/backgrounds.png 	-- Tilesheet
8 8 								-- Number of tiles in tilesheet
-----------------------------M---------------M-----------------------------------------M------------------------
--------M-------------------NL---------------LG----------------------------------------LO-------5667------------
-------NM--------------------M--------------NN-------------------------FG-------------NM--------899:------------
--------L-------------------NL--------FG-----LO--------FG------------------------------L--------------FG--------
5667----M--------56667-------M---------------M----------------------------------------NM----FG---\]-------------
899:----MO-------8999:---5667L--------------NM-------------FG--------------------------LO--------Z[-------------
--------L----------------899:MO--------------M-----------------------------------------M-FG------XY----<=-------
--------L--5667--------------L---------------LO----------------------------------------L------------------------
--------M--899:--------------M---------------M---D--------------------------J----------M------------------------
-------NL--------------------LO--------------LO--E--------------------------K---------NL------------------------
--------L-------------------NM---------------M---------------_--------------B----------MO-----------------------
--------M--------------------M--------------NL---------------------a--------C----------L-------FG---------------
--------M--------------------M---------------MO-----------------------------C---------NM------------------------
--------M--------------------L---------------L------------------------------B----------L------------------------
HHAAHHHHHHAHAAHH------------------------------------------------------------B-----------------------------------
