TILEMAP
112 15 							-- Size of tile map in tiles
16 16 							-- Tile size & block size
images/blocks.png 	-- Tilesheet
8 8 								-- Number of tiles in tilesheet
----------------------------------------------------------------------------------------------------------------
----------------------------------------------------------------------------------------------------------------
----------------------------------------------------------------------------------------------------------------
----------------------------------------------------------------------------------------------------------------
-------------------------------------------=--------------------------------------------------------------------
------------------------------------5------>-----------------------------------------------------------=--------
---2--2--5----2-22----5-------------5--5-1->-------------------------------------------------------3--->--------
--------2-------------2------5--5-----3---->5-------------------6---6---6-------------5-----------3---->--------
-------------------------------------3---1->-----------------------------------------------------3----->--------
--1-3-----7----3---3----3---3-----3-------->----------------------------------------------------------->--------
---------------------------------------1-1->---------------------------------------------------1------->--------
---------------1------------3---1-----1---->-------------------6----------------------------------1---->--------
----5---161515--------5---------------5--1->-----------------------------------1-----------------1----->--------
--1---------------------1-------------1---->-------------------------------------------1---------------3--------
33333333333333333333333333333--333333333333133333333333333333333333333333333333333333333333333333333333333333333
