TILEMAP
112 15 							-- Size of tile map in tiles
16 16 							-- Tile size & block size
images/backgrounds.png 	-- Tilesheet
8 8 								-- Number of tiles in tilesheet
-----------------------------M---------------M------------------------------------------------------------------
--------M-------------------NL---------------LG-------------------------------------------------5667------------
-------NM--------------------M--------------NN--------------------------------------------------899:------------
--------L-------------------NL--------FG-----LO--------FG-------------------------------------------------------
5667----M--------------------M---------------M------------------------------------------------------------------
899:----MO---------------5667L--------------NM-------------FG---------------------------------------------------
--------L----------------899:MO--------------M--------------------------------------------------------<=--------
--------L--5667--------------L---------------LO------------------------------------------FG---------------------
--------M--899:--------------M---------------M---D--------------------------J-----------------------------------
-------NL--------------------LO--------------LO--E--------------------------K-----------------------------------
--------L-------------------NM---------------M---B--------------------------B-----------------------------------
--------M--------------------M--------------NL---C--------------------------C-----------------------------------
--------M--------------------M---------------MO--C--------------------------C-----------------------------------
--------M--------------------L---------------L---B--------------------------B-----------------------------------
HHAAHHHHHHAHAAHH---------------------------------B--------------------------B-----------------------------------
