TILEMAP
112 15 							-- Size of tile map in tiles
16 16 							-- Tile size & block size
images/blocks.png 	-- Tilesheet
8 8 								-- Number of tiles in tilesheet
----------------------------------------------------------------------------------------------------------------
-------------------------------------------------------2-2-2-2-2---2-2-2-2-2------------------------------------
--------------------------------------------------------2-2-2-2-2-2-2-2-2-2-2-----------------------------------
-------------------------------------------------------AAAAAAAAAA-AAAAAAAAAAA-----------------------------------
-------22222----------------------------------------------------------------------------------------------------
---------------------------------------------------65--------------------------------------------------=--------
-----------------------------------------------------------------------------------------------2---2--->--------
--------------------------------6-------------GI-----------------------------------------------GFFFI--->--------
--------161-----------------------------------EE-----------------------------------------------EEEEE--->--------
--------222-----------22------------------------------------------------------------------------------->--------
--22-----------------2222-------5------------------AA5AA------B7--------------------------33----------->--------
--22---15151----5---222-222-----------------------------------B---B----------------------33EE---------->--------
-------------------22----22---------11------------------------B---B----------1----------3333E3--------->--------
-------------------22----GFFF3FFFF3FFFFFFF33FFF3FBEEEEEEEEEEEEB---BFFFFFFFF3FI---------333E3EE3-------->--------
FF33FFFFFF3F33FFFFFFI----HKKKKK33KKKKKKKKKKKKKKKKBFF3FFFFFFFFFFI--DK33KKKKKKKJ--GFFFFFFFI--GFFFFFFF3FFFBFF3FFF3F
