TILEMAP
112 15 							-- Size of tile map in tiles
16 16 							-- Tile size & block size
images/blocks.png 	-- Tilesheet
8 8 								-- Number of tiles in tilesheet
----------------------------------------------------------------------------------------------------------------
---------------------------------------------------------22222222222222222222-----------------------------------
---------------------------------------------------------22222222222222222222-----------------------------------
---------------------------------------------------------AAAAAAAAAAAAAAAAAAAA-----------------------------------
----------------------------------------------------------------------------------------------------------------
-----------------------------------------------------6-------------------------------------------------=--------
-------------------------------------------------------------------------------------------------------<--------
-------------------------------------------------------------------------------------------------------<--------
---------6---------------------------------------------------------------------------------------------<--------
---------------------------------------------------CC5CC--------------------------------------------1--<--------
--------------------------------------------------------------D7--D--------------------------------1---<--------
-------15151--------------------------------------------------D---D-------------------------------1----<--------
--------------------------------------------------------------D---D------------------------------1-----<--------
-------------------------GFFF3FFFF3FFFFFFF33FFF3FBFFFFFFFFFFFFD---DFFFFFFFF3FI------------------1------<--------
FF33FFFFFF3F33FFFFFFI----HKKKKK33KKKKKKKKKKKKKKKKBKK3KKKKKKKKKDI--DK33KKKKKKKJ-GFFFFFFFFFFFFFFFFFFFFFFFFFFFFFFFF
