TILEMAP
112 15 							-- Size of tile map in tiles
16 16 							-- Tile size & block size
images/blocks.png 	-- Tilesheet
8 8 								-- Number of tiles in tilesheet
----------------------------------------------------------------------------------------------------------------
-------------------------------------------------------2-2-2-2-2---2-2-2-2-2------------------------------------
--------------------------------------------------------2-2-2-2-2-2-2-2-2-2-2-----------------------------------
-------------------------------------------------------AAAAAAAAAA-AAAAAAAAAAA-----------------------------------
-------22222----------------------------------------------------------------------------------------------------
---------------------------------------------------65--------------------------------------------------=--------
-----------------------------------------------------------------------------------------------22222--->--------
--------------------------------6-------------GI-----------------------------------------------GFFFI--->--------
--------161-----------------------------------EE-----------------------------------------------EEEEE--->--------
--------222-----------22-------------------------------------------------------------------3----------->--------
--22-----------------2222-------5------------------AA5AA------D7--------------------------33----------->--------
--22---15151--------222-222-----------------------------------D---D----------------------33E----------->--------
-------------------22----22---------11------------------------D---D----------1----------3333----------->--------
-------------------22----GFFF3FFFF3FFFFFFF33FFF3FBEEEEEEEEEEEED---DFFFFFFFF3FI---------333E3----------->--------
FF33FFFFFF3F33FFFFFFI----HKKKKK33KKKKKKKKKKKKKKKKBFF3FFFFFFFFFDI--DK33KKKKKKKJ--GFFFFFFFI--GFFFFFFFFFFFFFFFFFFFF
