TILEMAP
112 15 							-- Size of tile map in tiles
16 16 							-- Tile size & block size
images/blocks.png 	-- Tilesheet
8 8 								-- Number of tiles in tilesheet
----------------------------------------------------------------------------------------------------------------
-------------------------------------------------------2-2-2-2-2---2-2-2-2-2------------------------------------
--------------------------------------------------------2-2-2-2-2-2-2-2-2-2-2-----------------------------------
-------------------------------------------------------AAAAAAAAAA-AAAAAAAAAAA-----------------------------------
-------22222----------------------------------------------------------------------------------------------------
---------------------------------------------------65-----------------------------1--1--3---------------=-------
----------------------------------------------------------------------------------3--1111------2---2---->-------
----------------1---------------6-------------GI----------------------------------1---3---A----GFFFI---->-------
--------161-----------------------------------EE----------------------------------11331--------EEEEE---->-------
--------222-----------22-------------------------------------------------------------------------------->-------
--22-----------------2222----5--5----------------M--AA5AA-----B7--------------------------33------------>-------
--22---15151----5---222-222----------------------L------------B---B----------------------33EE----------->-------
-------------------22----22---------11-----------L------------B---B----------1----------3333E3---------->-------
-------------------22----GFFF3FFFF3FFFFFFF33FFF3FMEEEEEEEEEEEEB---BFFFFFFFF31I---------333E3EE3--------->-------
FF33FFFFFF3F33FFFFFFI----HKKKKK33KKKKKKKKKKKKKKKKFFF3FFFFFFFFFFI--BK33KKKKKKKJ--GFFFFFFFI--GFFFFFFF3FFFBFF3FFF3F
