TILEMAP
112 15 							-- Size of tile map in tiles
16 16 							-- Tile size & block size
images/backgrounds.png 	-- Tilesheet
8 8 								-- Number of tiles in tilesheet
-----------------------------M----------------------------------------------------------------------------------
--------M-------------------NL---------------FG-------------------------------------------------5667------------
-------NM--------------------M------------------------------------------------------------------899:------------
--------L-------------------NL--------FG---------------FG-------------------------------------------------------
5667----M--------------------M----------------------------------------------------------------------------------
899:----MO---------------5667L-----------------------------FG---------------------------------------------------
--------L----------------899:MO-----------------------------------------------------------------------<=--------
--------L--5667--------------L-----------------------------------------------------------FG---------------------
--------M--899:--------------M-------------------D--------------------------J-----------------------------------
-------NL--------------------LO------------------E--------------------------K-----------------------------------
--------L-------------------NM-------------------B--------------------------B-----------------------------------
--------M--------------------M-------------------C--------------------------C-----------------------------------
--------M--------------------M-------------------C--------------------------C-----------------------------------
--------M--------------------L-------------------B--------------------------B-----------------------------------
HHAAHHHHHHAHAAHH---------------------------------B--------------------------B-----------------------------------
